[x][x][x][x][x][x][x][x]
[x][_][_][_][x][_][s][x]
[x][_][x][_][x][x][_][x]
[x][_][x][_][_][_][_][x]
[x][_][_][_][o][x][x][x]
[x][x][x][x][x][x][x][x]
