[x][x][x][x][x][x][x][x]
[x][o][_][x][_][_][_][x]
[x][x][_][x][_][x][_][x]
[x][_][_][_][_][x][_][x]
[x][_][x][x][s][x][_][x]
[x][x][x][x][x][x][x][x]
