[x][x][x][x][x][x][x][x]
[x][o][_][x][_][_][_][x]
[x][x][_][x][_][x][_][x]
[x][_][_][_][_][x][s][x]
[x][_][x][x][x][x][x][x]
[x][x][x][x][x][x][x][x]
