[x][x][x][x][x][x][x][x]
[x][_][x][_][_][_][o][x]
[x][_][x][_][x][x][x][x]
[x][_][_][_][x][_][_][x]
[x][s][x][x][x][x][_][x]
[x][x][x][x][x][x][x][x]
