[x][x][x][x][x][x][x][x]
[x][_][x][_][_][_][_][x]
[x][s][x][_][x][x][_][x]
[x][_][_][_][x][_][o][x]
[x][x][x][x][x][_][x][x]
[x][x][x][x][x][x][x][x]
