[x][x][x][x][x][x][x][x]
[x][_][_][_][x][_][_][x]
[x][_][x][_][x][x][s][x]
[x][_][x][_][_][_][_][x]
[x][o][x][x][x][x][x][x]
[x][x][x][x][x][x][x][x]
