[x][x][x][x][x][x][x][x]
[x][s][x][_][_][_][_][x]
[x][_][x][_][x][x][_][x]
[x][_][x][_][x][_][_][x]
[x][_][_][_][x][_][o][x]
[x][x][x][x][x][x][x][x]
