[x][x][x][x][x][x][x][x]
[x][x][x][_][_][x][x][x]
[s][_][_][_][x][x][o][x]
[x][x][x][_][x][x][_][x]
[x][x][x][_][_][_][_][x]
[x][x][x][x][x][x][x][x]
